#1 STAGE

world_map=np.array([[9,9,9,9,9,9,9,9,9],
                    [9,9,9,9,9,0,-1,9,9],
                    [9,9,0,0,2,0,0,9,9],
                    [9,9,0,2,0,2,9,9,9],
                    [9,0,0,9,9,9,9,9,9],
                    [9,0,1,0,0,1,0,9,9],
                    [9,0,1,0,1,0,0,10,9],
                    [9,9,9,9,9,9,9,9,9]])
'''-1=player, 0=void, 1=block, 2=skul, 4=locker, 9=wall, 10=devil or goal'''

spike_map=np.array([[0,0,0,0,0,0,0,0,0],
                    [0,0,0,0,0,0,0,0,0],
                    [0,0,0,0,0,0,0,0,0],
                    [0,0,0,0,0,0,0,0,0],
                    [0,0,0,0,0,0,0,0,0],
                    [0,0,0,0,0,0,0,0,0],
                    [0,0,0,0,0,0,0,0,0],
                    [0,0,0,0,0,0,0,0,0]])
                    
'''0=void, 1=spike, 2=moving spike on, 3=moving spike off, 4=key'''



#2 STAGE

world_map=np.array([[9,9,9,9,9,9,9,9,9,9],
                    [9,9,9,0,0,0,10,0,9,9],
                    [9,9,9,9,9,9,9,4,9,9],
                    [9,9,9,0,0,0,0,0,-1,9],
                    [9,9,9,0,9,0,9,0,0,9],
                    [9,9,9,0,0,2,0,0,9,9],
                    [9,0,9,0,9,0,9,0,9,9],
                    [9,0,0,0,0,0,2,0,9,9],
                    [9,9,9,9,9,9,9,9,9,9]])

'''-1=player, 0=void, 1=block, 2=skul, 3=key, 4=locker, 9=wall, 10=devil or goal'''

spike_map=np.array([[0,0,0,0,0,0,0,0,0,0],
                    [0,0,0,0,0,0,0,0,0,0],
                    [0,0,0,0,0,0,0,0,0,0],
                    [0,0,0,0,1,1,0,0,0,0],
                    [0,0,0,1,0,1,0,0,0,0],
                    [0,0,0,0,0,0,1,1,0,0],
                    [0,4,0,1,0,1,0,0,0,0],
                    [0,0,0,0,0,0,0,0,0,0],
                    [0,0,0,0,0,0,0,0,0,0]])

'''0=void, 1=spike, 2=moving spike on, 3=moving spike off, 4=key'''



#3 STAGE

world_map=np.array([[9,9,9,9,9,9,9,9,9,9],
                    [9,-1,9,0,0,1,9,9,9,9],
                    [9,0,1,0,1,0,4,0,9,9],
                    [9,1,0,1,0,1,1,0,10,9],
                    [9,0,1,0,1,0,1,1,0,9],
                    [9,9,0,1,0,1,0,9,9,9],
                    [9,9,9,9,9,9,9,9,9,9]])

'''-1=player, 0=void, 1=block, 2=skul, 3=key, 4=locker, 9=wall, 10=devil or goal'''

spike_map=np.array([[0,0,0,0,0,0,0,0,0,0],
                    [0,0,0,4,0,0,0,0,0,0],
                    [0,0,0,1,1,0,0,0,0,0],
                    [0,0,0,0,0,0,0,0,0,0],
                    [0,0,0,0,0,0,0,0,0,0],
                    [0,0,0,0,0,0,0,0,0,0],
                    [0,0,0,0,0,0,0,0,0,0]])

'''0=void, 1=spike, 2=moving spike on, 3=moving spike off, 4=key'''



#4 STAGE

world_map=np.array([[9,9,9,9,9,9,9,9],
                    [9,9,9,9,0,10,9,9],
                    [9,9,9,0,4,1,0,9],
                    [9,-1,9,0,0,1,0,9],
                    [9,0,9,0,0,0,0,9],
                    [9,2,9,1,1,1,1,9],
                    [9,0,0,0,0,0,0,9],
                    [9,9,9,9,9,9,0,9],
                    [9,9,9,9,9,9,9,9]])

'''-1=player, 0=void, 1=block, 2=skul, 3=key, 4=locker, 9=wall, 10=devil or goal'''

spike_map=np.array([[0,0,0,0,0,0,0,0],
                    [0,0,0,0,0,0,0,0],
                    [0,0,0,0,0,0,0,0],
                    [0,0,0,3,0,0,0,0],
                    [0,0,0,0,3,0,3,0],
                    [0,0,0,0,0,0,0,0],
                    [0,3,0,3,0,0,3,0],
                    [0,0,0,0,0,0,4,0],
                    [0,0,0,0,0,0,0,0]])
                    
'''0=void, 1=spike, 2=moving spike on, 3=moving spike off, 4=key'''



#5 STAGE

world_map=np.array([[9,9,9,9,9,9,9,9,9],
                    [9,9,0,-1,0,9,9,9,9],
                    [9,9,1,1,1,9,9,9,9],
                    [9,0,0,0,0,9,9,9,9],
                    [9,9,0,1,0,0,9,9,9],
                    [9,9,2,9,1,1,0,0,9],
                    [9,9,0,0,1,0,2,9,9],
                    [9,9,9,9,9,4,1,0,9],
                    [9,9,9,9,9,0,10,9,9],
                    [9,9,9,9,9,9,9,9,9]])

'''-1=player, 0=void, 1=block, 2=skul, 4=locker, 9=wall, 10=devil or goal'''

spike_map=np.array([[0,0,0,0,0,0,0,0,0],
                    [0,0,0,0,0,0,0,0,0],
                    [0,0,0,0,0,0,0,0,0],
                    [0,0,0,0,4,0,0,0,0],
                    [0,0,3,3,0,0,0,0,0],
                    [0,0,0,0,0,0,0,0,0],
                    [0,0,0,0,0,0,0,0,0],
                    [0,0,0,0,0,0,0,0,0],
                    [0,0,0,0,0,0,0,0,0],
                    [0,0,0,0,0,0,0,0,0]])
                    
'''0=void, 1=spike, 2=moving spike on, 3=moving spike off, 4=key'''



#6 STAGE

world_map=np.array([[9,9,9,9,9,9,9,9],
                    [9,0,0,0,0,0,0,9],
                    [9,0,0,0,0,0,0,9],
                    [9,0,0,0,0,0,0,9],
                    [9,0,0,0,0,0,0,9],
                    [9,0,0,0,0,0,0,9],
                    [9,0,0,0,0,0,0,9],
                    [9,0,0,0,0,0,0,9],
                    [9,9,9,9,9,9,9,9]])

'''-1=player, 0=void, 1=block, 2=skul, 3=key, 4=locker, 9=wall, 10=devil or goal'''

spike_map=np.array([[0,0,0,0,0,0,0,0],
                    [0,0,0,0,0,0,0,0],
                    [0,0,0,0,0,0,0,0],
                    [0,0,0,0,0,0,0,0],
                    [0,0,0,0,0,0,0,0],
                    [0,0,0,0,0,0,0,0],
                    [0,0,0,0,0,0,0,0],
                    [0,0,0,0,0,0,0,0],
                    [0,0,0,0,0,0,0,0]])
                    
'''0=void, 1=spike, 2=moving spike on, 3=moving spike off, 4=key'''